15 15
_ W _ # _ _ _ _ _ _ _ _ _ _ _
_ # _ # _ _ _ _ _ _ _ # _ # #
_ # K # _ _ _ _ _ _ _ _ # _ _
_ # # # _ # # # _ _ _ _ _ _ _
_ _ _ _ _ # T _ P _ _ _ _ _ #
_ _ _ _ _ # # # _ _ _ _ _ _ _
_ _ _ _ _ _ _ _ _ _ _ _ _ _ _
_ _ _ _ _ _ _ _ # # # # # # #
_ _ _ # # _ # _ # S _ _ _ _ _
_ # # # # _ _ _ # # # # # _ _ 
_ _ _ # # # # _ _ _ _ _ # _ _
_ _ _ _ _ # # _ _ _ _ _ # _ _
# # _ _ _ _ # _ _ _ _ _ # # _
D # # _ _ _ # _ _ _ _ _ _ # _
_ _ L _ _ _ _ _ _ _ _ _ _ _ _